chin: barbilla
duel: duelo
admire: admirar/elogiar
bud: capulo/yema
coconut: coco
currency: moneda extranjera
fillet: filete
gold: oro
aboard: abordar
accept: aceptar/admitir
also: tambien
backpack: mochila
camp: campamento
cap: gorra
chord: acorde
clad: vestido
collect: recoger
cook: cocinar
day: dia
development: desarrollo
educate: educar
exit: salida
for: por, para
gaiety: alegria
it: eso
people: gente
abandon: abandonar
abduct: secuestrar
about: más o menos, acerca de
absolutely: absolutamente
accident: accidente/casualidad
active: activo
again: otra vez
airplane: avión
and: y
as: como(en calidad de)
be: ser o estar
board: pizarra
buff: entusiasta
building: edificio
campus: ciudada universitaria
can: poder
cardiac: cardiaco
cellphone: teléfono móvil
chocolate: chocolate
chop: cortar algo
christmas: navidad
chubby: regordete
clean: limpieza
client: cliente
cod: bacalao
code: código
colony: colonia
come: venir
couple: pareja
create: crear/producir
custom: costumbre
daft: bobo
delete: borrar/tachar
dentist: dentista
dirt: suciedad/mugre
doctrine: doctrina
duly: debidamente
dutiful: obediente
egg: huevo
elegant:  elegante
facet: faceta
fake: imitacion
finger: dedo
firing: tiroteo
from: de
fully: completamente
gem: piedra preciosa
gig: actuacion
hand: mano
him: él
man: hombre
new: nuevo
than: que
two: dos
abilty: talento/capacidad/aptitud
absorb: absorber
access: acceso
account: cuenta
actor: actor
actress: actriz
all: todo
at: en/a
balloon: globo
because: porque
bottle: botella
box: caja
buddy: colega
buffer: amortiguador/tope/memoria intermedia
but: sino que, pero
by: por, para
cancel: cancelar
card: tarjeta
cardigan: chaqueta
carrot: zanahoria
chair: silla
cheer: aclamar/animar/alegrar
choral: coral
chuck: tirar
clan: clan
clef: clave
cliff: acantilado
cock: gallo
coffee: café
computer: computadora
could: podria
crab: cangrejo
cult: culto
cunning: astuto
curt: brusco
dab: tocar algo ligeramente
darling: encanto
database: base de datos
delegate: delegado
den: guardia
deny: negar
deploy: desplegar/se
diamond: diamante
diary: diario
disc: disco
discard: desechar/desecharse de
dog: perro
done: hecho
duke: duque
dumb: mundo
dystrophy: distrofia
ear: oreja
effect: efecto
elbow: codo
engineer: ingeniero/a
engineering: ingenieria
explain: explicar/aclarar algo
extreme: extremo
factor: factor
fairly: justamente/equitativamente
fame: fama
female: femenino
find: encontrar/hallar/buscar
firefighter: bombero
first: primero
floor: suelo
forever: para siempre
fruit: fruta
fumble: maniplar torpemente algo
fun: diversion
gait: paso/andar
game: juego
generally: generalmente
get: dar en, obtener
glasses: lentes/gafas/anteojos
globe: globo
grade: clase/categoria
guard: proteger/guardar
haul: tirar/arrastrar
he: él
hob: plancha
hour: hora
just: solo
know: saber
marker: marcador
mirror: espejo
of: de
or: ó
school: escuela/colegio
snitch: soplon
them: ellos
they: ellos
vegetable: verdura
way: camino
address: dirección
bubble: burbuja
calm: tranquilo
cash: dinero
charger: cargador
cheese: queso
chess: ajedrez
cocoa: cacao
cupboard: armario
dawn: amanecer
desk: escritorio
diet: dieta
do: hacer
documentary: documental
dominant: dominante
doze: dormitar
duct: conducto
eat: comer
even: emparejar
fabulous: fabuloso
fairy: hada
fall: caida
feel: sentir/tocar
fever: fiebre
fib: cuento
flower: flor
funny: gracioso/divertido
gaunt: demacrado
gift: regalo
give: recibir
global: mundial
glove: guante
go: ir
gory: sangriento
grubby: sucio
gun: arma
habit: costumbre
hard: duro
have: tener
heart: corazon
her: ella
hint: insinuacion
hip: cadera
hoist: levantar
honest: honrado
hub: cubo
i: yo
its: su,sus,suyo
keyboard: teclado
like: gustar
look: mirar
many: muchos
me: mí
more: más
mouse: ratón
no: no
not: no
on: sobre, encima de
one: uno
our: nuestro
pail: balde
photography: fotografía
picture: imagen/cuadro/retrato
see: ver
she: ella
some: algunos
table: mesa
that: eso,esa
the: el,la,los
then: entonces
there: ahi
think: pensar
those: esos
umbrella: paraguas
up: arriba
very: muy
wallet: cartera
when: cuándo
window: ventana
chew: masticar algo
dud: defectuoso
field: campo
god: Dios
hair: pelo/cabello
here: aqui
his: su
hope: esperanza
how: como
humid: humedo
if: si(condicional)
in: en
make: preparar
my: mi, mis
now: ahora
only: solo
other: otro
out: fuera de
pen: bolígrafo/lapicero
pencil: lápiz
shirt: camisa
so: tan
syrup: jarabe
take: tomar
teacher: profesor/a
their: sus
these: estos, estas
thing: cosa
this: esta
thread: hilo
time: tiempo
use: usar
want: querer
we: nosotros
well: bien, bueno
which: cuál
will: intencion, voluntad, deseo
with: con
would: haría
into: dentro de
pendriver: memoria portatil
tell: decir
to: hacia, para
what: qué
year: año
you: tú
your: tus